00000000000000000000
01011110011111111000
01000011000101001000
01110010000001001110
00011110000000111010
01010001000100001010
11000111111100111010
01111101001001101010
00100101101000101000
01100100101100100110
01011101100100100100
01110000000100111110
01001111111110100010
01100001000010101010
00101011101010101011
01111000001011101000
00101011101110001100
01101000111000100100
01001111101111111100
00000000000000000000
