00000000000000000000
11110001000111111000
00010011111100001110
00011110000111100000
00010100000100111110
00010100000100100000
00010111000100100000
00010001000100100000
00111111111111111100
01100001000000100100
00100001011110100100
00111001010010100111
00101001010011111000
00001001011010000000
00001001000011111000
00011001111110001100
00001000001000001000
00001111111000001000
00001000000000001000
00000000000000000000
