00000000000000000000
01000011100111110000
01111110100100010000
00000010100101010000
11111111111111110111
00010010000000010100
00010010010001110100
00010010010001010100
00010111111111110100
00010010001010100100
01010011011011101100
01111101010000001000
01000101011011111000
01000101001010101000
01010101111010101110
01010100000010100010
01110111111110100010
00010000101000111110
00011111101111100000
00000000000000000000
