00000000000000000000
00000000000011111110
00000000000010000010
00000011111010000010
00000010101010000010
00000010111110000010
01111111010000000010
00001001010000000010
00001001111111111110
01111001000001010010
01000001000001010010
11111111000111010010
00000001000100010010
00000000000100010010
00000000000111110011
00000000000000000000
00000000000000000000
00000000000000000000
00000000000000000000
00000000000000000000
