00000000000000000000
00010000000000000000
00100000000000000000
00000000000000000000
00010000000000000000
00000000000000000000
00000000000000000000
00000000000000000000
00011111110000000000
00010000010000001111
11111111111111111100
00000000000000000000
00000001000000000000
00000000000000000000
00000000000000000000
00000000000000000000
00000000000000000000
00000000000000000000
00000000000000000000
00000000000000000000
